52,694,85,666,100,681,102,693,114,696,158,672,169,677,179,674,198,652,237,645,241,657,249,658,260,671,297,683,307,690,306,702,300,709,305,719,340,698,357,710,355,732,309,732,303,748,260,794,216,798,170,794,160,754,113,748,87,746
85,659,100,676,104,690,114,693,159,665,166,671,176,671,193,649,184,640,193,621,207,621,210,607,230,574,236,571,240,582,254,582,251,554,247,525,237,530,231,522,223,530,210,533,186,528,190,487,177,478,185,432,194,431,199,421,214,415,206,405,212,395,200,391,190,400,171,399,162,366,172,365,166,353,144,343,136,356,120,351,127,344,113,323,113,339,103,349,87,323,78,327,78,338,52,345,30,332,11,339,3,379,12,424,36,425,66,473,62,497,89,497,104,514,87,542,119,565,117,588,103,605,96,626,77,630,74,646
306,709,309,701,310,686,298,678,263,668,249,650,238,639,198,646,188,638,195,625,211,623,233,576,241,587,257,585,253,522,239,521,233,514,217,525,194,522,196,481,184,474,190,438,199,434,202,424,219,417,213,403,217,392,232,386,249,395,262,407,288,389,311,395,317,411,338,430,348,425,352,432,367,443,369,452,376,453,371,471,343,467,339,487,327,494,314,505,311,525,303,537,309,543,368,545,383,567,388,592,400,602,377,629,396,646,378,646,363,660,362,666,348,661,343,678,340,692,316,707
446,789,360,731,360,706,345,694,352,666,365,670,368,660,381,651,401,652,397,641,385,631,408,602,395,592,387,563,371,539,309,537,319,508,343,490,347,472,372,477,382,453,373,448,366,430,380,395,372,388,383,369,401,369,411,360,442,361,503,405,515,394,559,407,547,499,514,533,490,563,496,571,482,615,463,634,450,646,455,659,441,661,455,682,440,706
31,327,51,339,73,335,74,322,91,318,103,340,110,337,111,318,131,341,131,349,144,337,174,351,177,366,169,371,174,393,185,395,202,385,214,387,234,381,265,401,286,384,316,393,319,409,337,425,350,419,363,436,362,426,374,399,367,388,377,366,397,362,410,356,405,343,354,309,346,255,317,212,289,205,293,175,275,141,282,59,273,25,242,10,240,25,211,20,202,2,161,11,158,54,112,75,110,118,90,124,93,144,82,174,62,183,64,198,73,212,70,222,56,232,32,239,21,284,2,311,17,318
